arbeitsamt -> (out) arbeits, amt
krankenhaus -> (out) kranken, haus
kraftfahrer -> (out) kraft, fahrer
online -> (out) online
büro -> (out) büro
erzieher -> (out) erzieher
teilzeit -> (out) teil, zeit
erzieherin -> (out) erzieherin
verkäuferin -> (out) verkäuferin
sekretärin -> (out) sekretärin
minijob -> (out) minijob
arzthelferin -> (out) arzthelferin
marketing -> (out) marketing
meister -> (out) meister
küchenhilfe -> (out) küchen, hilfe
koch -> (out) koch
reinigungskraft -> (out) reinigungskraft
bundeswehr -> (out) bundes, wehr
sozialarbeit -> (out) sozialarbeit
sport -> (out) sport
bosch -> (out) bosch
fahrer -> (out) fahrer
ausland -> (out) ausland
praktikum -> (out) praktikum
medizinische -> (out) medizinische
rathaus -> (out) rat, haus
bürokraft -> (out) büro, kraft
schweißer -> (out) schweißer
jurist -> (out) jurist
vollzeit -> (out) vollzeit
soziale -> (out) soziale
medien -> (out) medien
aushilfe -> (out) aushilfe
arzt -> (out) arzt
mode -> (out) mode
bürokauffrau -> (out) büro, kauffrau
kaufmann -> (out) kauf, mann
englisch -> (out) englisch
chemiker -> (out) chemiker
kindergarten -> (out) kinder, garten
rewe -> (out) rewe
klinikum -> (out) klinikum
pädagogik -> (out) pädagogik
hausmeister -> (out) haus, meister
pharma -> (out) pharma
lidl -> (out) lidl
pta -> (out) pta
psychologie -> (out) psychologie
lebensmittel -> (out) lebens, mittel
lebenshilfe -> (out) lebens, hilfe
vertrieb -> (out) vertrieb
heimarbeit -> (out) heim, arbeit
zeitung -> (out) zeitung
klinik -> (out) klinik
verlag -> (out) verlag
berufskraftfahrer -> (out) berufskraftfahrer
airbus -> (out) airbus
flughafen -> (out) flug, hafen
altenpflegerin -> (out) alten, pflegerin
nebenjob -> (out) nebenjob
edeka -> (out) edeka
uni -> (out) uni
heilerziehungspfleger -> (out) heilerziehungspfleger
bankkauffrau -> (out) bank, kauffrau
einzelhandel -> (out) einzel, handel
altenheim -> (out) alten, heim
buchhalter -> (out) buch, halter
energie -> (out) energie
empfang -> (out) empfang
gastronomie -> (out) gastronomie
altenpflege -> (out) alten, pflege
versicherung -> (out) versicherung
architekt -> (out) architekt
feuerwehr -> (out) feuer, wehr
zeitarbeit -> (out) zeit, arbeit
weihnachtsmarkt -> (out) weihnachtsmarkt
bautechniker -> (out) bau, techniker
französisch -> (out) französisch
it -> (out) it
biologie -> (out) biologie
mercedes -> (out) mercedes
staplerfahrer -> (out) stapler, fahrer
lagerlogistik -> (out) lagerlogistik
tageszeitung -> (out) tages, zeitung
bauzeichner -> (out) bauzeichner
stadtwerke -> (out) stadt, werke
helfer -> (out) helfer
polizei -> (out) polizei
ingenieur -> (out) ingenieur
immobilien -> (out) immobilien
landratsamt -> (out) landratsamt
assistenzarzt -> (out) assistenz, arzt
kita -> (out) kita
textil -> (out) textil
hotel -> (out) hotel
bildung -> (out) bildung
fotograf -> (out) foto, graf
sap -> (out) sap
bahn -> (out) bahn
volksbank -> (out) volks, bank
